#########&#########
#.................#
#.................#
#........#........#
#.................#
#.................#
#.................#
#......##&##......#
#......#...#......#
&......&.@.&......&
#......#...#......#
#......##.##......#
#.................#
#.......#.#.......#
#.................#
#.................#
#.................#
#.................#
#########&#########
