###################
#.................#
#.................#
#........#........#
#.................#
#.................#
#.................#
#......#####......#
#......#...#......#
#......#.@.#......#
#......#...#......#
#......##.##......#
#.................#
#.......#.#.......#
#.................#
#.................#
#.................#
#.................#
###################
